###################
###################
###################
###################
###################
###################
###################
###################
###################
#WWWWWWWWWWWWWWW###
#WDoooooOOoooo$W###
#WWWWWWWWWWWWWWW###
###################
###################
##################