###################
###################
###################
###################
###################
###################
#############WWW###
#####WWWWWWW#WDW###
#####WoooooW#WoW###
#WWWWWoWWWoWWWoW###
#W$oooOOOOOooooW###
#WWWWWWWWWWWWWWW###
###################
###################
###################
