###################
###################
###################
###################
###################
###################
#############WWW###
#####WWWWWWW#WDW###
#####WoooooW#WoW###
#WWWWWoWWWoWWWoW###
#W$ooooW#WoooooW###
#WWWWWWW#WWWWWWW###
###################
###################
###################