###################
###################
###################
###################
###################
###################
##WWW########WWW###
##WDW########W$W###
##WoWWWWW####WoW###
##WoWWooWWWWWWoW###
##WooooPoooooooW###
##WooWWWWooWWooW###
##WWWW##WWWWWWWW###
###################
###################