###################
###################
###################
###################
###################
###################
##WWW########WWW###
##WDW########W$W###
##WoWWWWW####WoW###
##WOWWooWWWWWWoW###
##WooooooooooooW###
##WooWWWWPoWWooW###
##WWWW##WWWWWWWW###
###################
###################