###################
###################
###################
###################
###################
###################
##WWW########WWW###
##WDW########W$W###
##WoW########WoW###
##WoW####WWWWWoW###
##WoWWW##WoooooW###
##WOoooWWWoWWWWW###
##WLWOOOORoW#######
###WWWWWWWW########
###################
