###################
###################
###################
###################
###################
###################
##WWW########WWW###
##WDW########W$W###
##WoWWWWW####WoW###
##WOWWooWWWWWWoW###
##WooooooLoooooW###
##WooWWWWooWWooW###
##WWWW##WWWWWWWW###
###################
###################