###################
#WWWWWWWWWWWWWWWW##
#WoooRoooooWWoooW##
#WoWoWWooooWWEWoW##
#WoooooooooWWWooW##
#WWoWWWWooWWWWoW###
##WoW#WoooTW#WoW###
##W$W#WooooW#WDW###
##WWW#WWWWWW#WWW###
###################
###################
###################
###################
###################
###################