###################
#WWWWW######WWWWW##
#WoooWWWWWWWWoooW##
#WoWoWWooooWWoWoW##
#WooooooooooooooW##
#WWoWWWWooWWWWoW###
##WoW#WooooW#WoW###
##W$W#WToooW#WDW###
##WWW#WWWWWW#WWW###
###################
###################
###################
###################
###################
###################