###################
#WWWWW######WWWWW##
#WoooWWWWWWWWoooW##
#WoooWWooooWWoooW##
#WWooooooooooooWW##
##WoWWWWooWWWWoW###
##WoW#WooooW#WoW###
##W$W#WDoooW#WWW###
###################
###################
###################
###################
###################
###################