###################
###################
###################
###################
###################
###################
#############WWW###
#############W$W###
####WWWWWWWWWWoWWW#
#WWWWoNooooooooooW#
#WDoooooooooNooooW#
#WWWoooooooooooooW#
###WWWWWWWWWWWWWWW#
###################
###################