###################
###################
###################
###################
###################
###################
#############WWW###
#############WoW###
####WWWWWWWWWWoWWW#
#WWWWooooooooooooW#
#WDooooooToooooooW#
#WWWoooooooooooooW#
###WWWWWWWWWWWWWWW#
###################
###################