##############W####
######WWWWWWWWTW###
#####WOOOOOOOROW###
######WoWWWWWWOW###
######WoooWWWWOW###
#######WWOooooO$W##
########WSWWWWWW###
#########W#########
####WWWWWWWWWWWWWW#
#WWWWoooooWooNooEW#
#WDoooooooooooooW##
#WWWooWNoooWWoooW##
###WWWWWWWWWWWWW###
###################
###################
