###################
###################
###################
###################
###################
###################
#############WWW###
#############W$W###
####WWWWWWWWWWoWWW#
#WWWWoYooooooooooW#
#WDoooooooooYooooW#
#WWWoooooooooooooW#
###WWWWWWWWWWWWWWW#
###################
###################