###################
###################
###################
###################
###################
###################
#############WWW###
#############W$W###
####WWWWWWWWWWoWWW#
#WWWWooooooooooooW#
#WDooooooYoooooooW#
#WWWoooooooooooooW#
###WWWWWWWWWWWWWWW#
###################
###################