###################
###################
###################
###################
###################
###################
#############WWW###
######WWWWW##WDW###
###WWWWoooWWWWoWWW#
#WWWooooWooooWoooW#
#W$ooiiiZooooWoooW#
#WWWWoOOOOoooooooW#
####WWWWWWWWWWWWWW#
###################
###################
