###################
###################
###################
###################
###################
###################
#############WWW###
######WWWWW##WDW###
###WWWWoooWWWWoWWW#
#WWWoooWoooooWoooW#
#W$oooooZooooWoooW#
#WWWWoooWooooooooW#
####WWWWWWWWWWWWWW#
###################
###################