###################
###################
###################
###################
###################
###################
#############WWW###
######WWWWW##WDW###
###WWWWoooWWWWoWWW#
#WWWoooooooooWoooW#
#W$ooooooooooWoooW#
#WWWWoooWooooooooW#
####WWWWWWWWWWWWWW#
###################
###################