###################
###################
#WWWWWWWWWWWWWWW###
#WoooooooooooooW###
#WoWWWWWWWWWWWoWWWW
#WoWWWDoooooooOoooW
#WoWWWWWWWWWWWoWWoW
#WoWWWWWWWWWWW$WWoW
#WoWWWWWWWWWWWWWWoW
#WoWWooooWWooWWWWoW
#WooooooooooooooooW
#WWWWWWWooooooWWWWW
#######WWWWWWWW####
###################
###################