#########WWW#######
###WWWWWWiiiWWW####
###WDooiWiiiiWWW###
####WWWiWWiiiWWW###
####WwWiiWiiiWWW###
####WwWiiiiiiWWW###
####WwWiWiiiiOSW###
####WwWiiiiWiWWW###
####WwWiiiWWiooW###
####WwWiiWZWiWoW###
####WwWiiiiiiWoW###
####WwWiiiiiiWoW###
####WWWWWW$iiooW###
#########WWWWWWW###
###################
