###################
###################
###################
WWWWW###WWWWW######
WoooWWWWWoooW######
WoWoWW$WWoWoW######
WooOooOooOooWWWW###
WWWoWWoWWoWWWWDW###
#WWoWWoWWoWWWWoWW##
#WooooOooOooWWooW##
#WoooWoWWoWoWoooW##
#WoooooWWoooWoWWW##
#WoWWWWWWWWWWoooW##
#WooooooooooooooW##
#WWWWWWWWWWWWWWWW##