###WWWWW###########
##WDooooW##########
##WWWWooWWWW#######
##WiiiiWiiiW#######
##WiiWiiiiiW#######
##WiiiiiiiWW#######
##WiWiiiWiiW#######
##WiiiiiiiiW#######
##WWWWiiiiiW#######
#####WSWWiWW#######
######WWooW########
#######Wo$W########
########WWW########
###################
###################
