###################
###WWW#######WWW###
##Woo$W#####WooEW##
##WoooW#####WooWW##
##WTooW#####WWooW##
###WWW######WooNW##
############WoooW##
############WNooW##
############WooWW##
############WoooW##
############WWooW##
#############WoDW##
##############WW###
###################
###################